0! = 1! = 1	
1 dozen = 12	1打 = 12个
1 feet = 12 inches	1英尺 = 12英寸
1 gallon = 4 quarts	1加仑 = 4夸脱
1 hour = 3600 seconds	1小时 = 3600秒
1 mile = 5280 feet	1英里 = 5280英尺
1 yard = 3 feet = 36 inches	1码 = 3英尺 = 36英寸
3-digit number	三位数
a line segment	线段
a straight line	直线
a unique solution	唯一解
A diminished by B / A minus B / from A subtract B	A减去B
A divided by B	A/B
A divided into B	B/A
A is 20% less than B	(B-A)/B = 20%
A is 20% more than B	(A-B)/B = 20%
A is a divisor of B	A是B的除数(约数)(B/A)
A is subset of B	A是B的子集
A multiplied by B	A乘以B
abscissa/x-coordinate	横坐标
absolute value	绝对值
account for	占（比例）
acute angle	锐角
add/plus	加
adjacent angle	邻角
alongside	和...一起
alternate angle	内错角
altitude	（三角形的）高
angle bisector	角平分线
angle measurement in degrees	角度计算
approximate cost	估算成本，约计成本
approximately	近似，大约
arc	弧
area of a rectangle	长方形的面积
arithmetic mean	算术平均数
arithmetic procession	等差数列
arm	直角三角形的股
as illustrated	如图所示
at random	随机
average	平均数
axis	轴
balance	余额
bar graphs/histogam	柱状图，直方图
base/power	底数/指数，幂
be direct(inverse) proportion at/to	成反比
be drawn to scale	按比例绘制
be fewer than	小于
be less than	小于
be more than twice as many X in A as in B	A里面的X是B里面X的2倍以上
be parallel of	平行
be perpendicular to	垂直
be proportional to	与..成比例的
be tangent to	与...相切
bisect	平分
blot out	涂掉，删掉
boxplots	箱形图
buck	一美元，一澳元
calculate to three decimal places	结果保留3位小数
cardinal	基数
categories	种类
center of a circle	圆心
central angle	圆心角
central tendency	集中趋势
charge	收费
charter	租赁，包租，执照，特许
chord	弦
circle graphs	饼图
circle	圆形
circumference	圆周长，周长
circumscribed	外接的
circumscribe	外切，外接
clockwise	顺时针
closest appoximation	最相近似的
coefficient	系数
combination	组合 C = n!/m!(n-m)!
common factor	公因子
common logarithm	常用对数
common multiple	公倍数
common ratio	公比
complementary angles	余角
complementary function	余函数
complex fraction	繁分数
composite number	合数
compound events	复合事件
compound interest	复利
concentration	浓度
concentric circles	同心圆
cone	圆锥
congruent angles	全等角
congruent line segments	等长线段
congruent	全等的
consecutive integer	连续整数
consecutive	连续的
constant rate	匀速的
constant term	常数项
constant	恒定不变的
continuous random variable	连续随机变量
coordinate geometry	解析几何
coordinate plane	坐标平面
coordinate system	坐标系
corresponding side	对应边
corresponding value	对应值
cost of production	产品成本
cross section	横截面
cube root	立方根
cube	立方体
cumulative	累积的，附加的
cylinder	圆柱体
decagon	十边形
decimal fraction	纯小数
decimal place	小数位
decimal point	小数点
decimal system	十进制
decrease by	减少了
decrease to	减少到
defined	已定义的
denominator	分母
denote	表示
depth	深度
diagonal	对角线
diameter	直径
difference	差
digit	位
dimension	维数
dime	一角，十分
direct proportion	正比
discount	折扣率
discrete randon variable	离散随机变量
disjoint	不相交的
dispersion	差量，离差
distinct point	不同点
distribution	（频数或频率）分布
divided evenly	被整除
dividend	被除数
divide	除
divisibility	可约性，可除性
divisible	可被整除的
division	除，部分
divisor	除数，约数，因子
domain	定义域
down payment	预付定金，首付款
edge	边
elements	元素
empty set	空集
endpoint	端点
equally likely event	等可能事件
equation	方程式，等式
equilateral triangle	等边三角形
equilateral	等边形的
equivalent equation	同解方程，等价方程
equivalent	相等的
estimation	估算，近似
even integer	偶数
event	事件
expected value	期望值，预期值
exponent	指数，幂
expression	表达式
exterior angle	外角
faces	面
factorial notation	阶乘
factorization	因数分解
feet	英尺
fold	对折
four quadrants	四个象限
frequency distribution	频率分布
from subtract	从...减...
function	函数
geometric mean	几何平均数
geometric progression	等比数列
greater than	大于
greatest common divisor/factor	最大公约数
grid lines	坐标线，网格线
gross profit	毛利
heads up	正面朝上，头朝上
heptagon	七边形
hexagon	六边形
hypotenuse	斜边，直角三角形的斜边，弦
identical	相等的
improper fraction	假分数
in equivalent to	与...相等
in excess of	超过
in term of	用...的话，用...来表示
in turn	依次，轮流
included angle	夹角
included side	夹边
inclusive	包括在内的
increase by	增加了
increase to	增加到
independent events	相互独立事件
inequality	不等式
infinite decimal	无穷小数
inscribed triangle	内接三角形
inscribe	内切，内接
installment	分期付款
integer	整数
intensity	强度
intercalary/leap year	闰年
intercepts	截取
intercept	截距
interior angle	内角
interquartile range	四分位差
intersection	交集
intersect	相交
interval	区间，间隔
inverse function	反函数
inverse	倒数
invert a fraction	求分数的倒数
invert	倒置，颠倒
irrantional number	无理数
is equal to	等于
isosceles triangles	等腰三角形
juxtaposition	并列
l and m are perpendicular	线l与线m垂直
least common multiple	最小公倍数
leg	直角边
length	长
less than	小于
lifetime	寿命
linear equation	线性方程
linear functions	线性函数
linear  	一次的，线性的
list price	标价
literal coefficient	字母系数
margin	利润，付定金
mark up	涨价
maximum	最大值
mean	平均值，平均数，中数
median of a triangle	三角形的中线
median	中数，中线，中线，中值
midpoint	中点
minimum	最小值
mixed number	带分数
mode	众数
multilateral	多边的
multiple	倍数
multiplication	乘
multiply/times	乘
mutual fund	共同基金
mutually exclusive	互斥的
natural number	自然数
nearest 0.1 percent	最接近0.1%
nearest whole percent	最接近的百分数
negative number	负数
negative whole integer	负整数
negligible	可忽略不计的
no less than	大于等于
no more than	小于等于
no solution	无解
nomal distribution	正态分布
nonagon	九边形
nonempty	非空的
nonnegative	非负的
nonzero number	非零数
number line	数轴
numerator	分子
numerical coefficient	数字系数
oblique	斜三角形
obtuse angle	钝角
octagon	八边形
odd integer	奇数
opposite angles	对角
opposite	直角三角形中的对边
ordinal	序数
ordinate	纵坐标
origin O	坐标原点O
origin	原点
overlap	重叠
parabola	抛物线
parallel lines	平行线
parallelogram	平行四边形
parentheses	括号
partition	分割，分开
pentagon	五边形
per capita	按照人数分配的，每人
percentiles	百分位数
percent	百分比
perimeter	周长
permutation (arrangement)	排列 A = n!/(n-m)!
perpendicular bisector	垂直平分线
perpendicular lines	垂直线
perpendicular	垂线
point of tangency	切点
pointer	指针
polygon	多边形
positive number	正数
positive whole integer	正整数
preceding	在...前的，先前的
prime factorization	质因数分解
prime factor	质因数
prime number	质数
principal	本金
probability distribution	概率分布
probability	概率
product	乘积
project	预测，估计
proper fraction	真分数
proper subset	真子集
property tax	财产税
purchases	销售数量
pyramid	角锥，金字塔，渐增
Pythagorean theorem	勾股定理
quadrant	象限
quadratic	二次方程
quadrilateral	四边形
quartiles	四分位数
quotient	商
radian	弧度（弧长/半径）
radical/root sign	根号
radicals	根式
radius	半径
random variables	随机变量
range	值域
rational	有理数
real number	实数
rebate	退还款，折扣
reciprocal/inverse	倒数
rectangle	长方形，矩形
rectangular coordinate	直角坐标系
rectangular solid	长方体
recurring decimal	循环小数
reflection	镜射
regular polygon	正多边形
regular solid/polyhedron	正多面体
relative frequency distributions	相关频率分布
remainder	余数
respectively	各自地，分别地
retail price	零售价
reversible	可逆的
rhombus	菱形
right angle	直角
right triangle	直角三角形
roll a fair die	掷骰子
round angle	周角
round	保留整数，四舍五入
sales revenue	销售额
sales taxes	营业税，销售税
satisfy	使...成立
scalene triangle	不等边三角形
scale	比例，刻度
scatterplot	点阵图
score	二十
segment of a circle	弧形
semicircle	半圆
sequences  of number	数列
sequence	数列
set of data/data set	数据集
sets	集合
similar triangles	相似三角形
simple fraction	简分数
simple interest	单利
simplification	简化
simplified	简化的
simultaneously	同时
sketch	草图，示意图
slope	斜率
solid color	纯色
solid line	实线
solution set	解集
solution	（方程组的）解
sphere	球体
spread	范围
square root	平方根
square	正方形
standard deviation	标准方差
standard normal distribution	标准正态分布
straight angle	平角
subset	子集
subtract/minus	减
successive	连续的
sufficient	充分的
sum	和
supplementary angles	补角
surface area	表面积
survey	调查
symmetric	对称的
symmetry	对称，对称性
S立方体 = 6a方	
S三 = 1/2底 * 高	
S梯 = （上底+下底）* h/2	
S圆 = πr方	
S圆柱 = 2πr（r+h）	
tails up	背面朝上，数字朝上
tangent line	切线
tangent	正切
tens digit	十位数
tenths unit	十分位
term	项
the difference of A and B	A与B的差
the intersection of A and B	A与B的交集
the product of A and B	A与B的乘积
the sum/total of A and B	A与B的和
the union of A and B	A与B的并集
The ratio of A to B is ...	A比B(A/B)
three-dimensional figures	三维图形
tie	打平
to the nearest/round to	四舍五入
toss up	掷硬币，（胜败）机会相等
total	总数，总计
trapezoid	梯形
trigonometric function	三角函数
truckload	一卡车的容量
Twice as many A as B	A是B的两倍
union	合集，并集
units digit	个位数
value	值，数值
variable/variations	变量
Venn diagrams	韦恩图
vertex angle	顶角
vertex	（三角形等）顶角，顶点
vertical angle	对顶角
volume	体积
vulgar/common fraction	普通分数
V长 = 长*宽*高	
V圆柱 = πr方h	
V圆锥 = 1/3πr方h	
wall	（容器的）壁
weighed average	加权平均值
weighted mean	加权平均数
weighted mean	加重量于...，使变重
width	宽
x-axis	x轴
x-intercept	x轴截距
xy-planes	xy平面坐标轴
y-axis	y轴
yields	产量
等比求和Sn = a1（1-qn方）/(1-q)	q不等于1
等比数列an = a1q（n-1）方	
等差求和Sn = n（a1+an）/2 = na1+n(n-1)d/2	
等差数列an = a1+（n-1）d	
多边形的内角和 = （n-2）*180	
弧长 = （X/360) * 圆周长	
利息 = principle(本金)*interest rate(利率)*time	
圆周长 = 2πr	
